XXXXXXXXXXXXXXXXXXXXXXXXXXXXXX
X............................X
X............................X
X.....B................B.....X
X............................X
X............................X
X............................X
X............................X
X............................X
X............................X
X............................X
X............................X
X............................X
X.....B................B.....X
X............................X
X............................X
XXXXXXXXXXXXXXXXXXXXXXXXXXXXXX